111111111111111111111111111
1P0000000000000000000000001
1000010000100C0100001000001
100001000011100100001000111
100001000010000100001000001
1000010C0010000111001000001
100001001110000100001000001
100011000010000100001111001
100001000010000100001000001
100001000010011100001000001
100C01000010000100111000001
100001000011000100001000001
100000000000000000000000NE1
111111111111111111111111111