1111111111111111
1P0000000000NCE1
1111111111111111