111111111111
1P000000C001
100000000001
100000000001
10000N000001
100000000001
1000000000E1
100000000001
111111111111